24 5
32 32 768 0
0 5 5 5 5 5 13 13 0 5 5 5 5 5 13 13 13 13 13 13 17 22 22 30
1 6 6 6 6 6 5 5 1 6 6 6 6 6 5 5 5 5 5 5 18 23 27 31
2 7 10 10 10 10 10 10 1 7 10 10 10 10 10 10 10 10 7 11 19 24 27 30
3 8 11 3 3 11 3 11 3 8 11 3 3 11 3 11 11 11 8 15 20 25 28 32
4 9 12 4 4 12 4 12 4 9 12 4 4 12 4 12 12 14 9 16 21 26 29 33
0 750 10 0 168
2 90 135 1 2
2 220 135 1 3
2 345 135 1 3
2 475 135 1 2
2 600 135 1 4
3 10 180 650 0 8 2
1 40 50